+-+-+-+-+-+-+-+-+-+-+          
|   |   |   |     | |          
+ + + + + + + +-+ + +          
| |   | | | | |   | |          
+ +-+-+-+ + + + +-+ +          
| |     | |   |   | |          
+ +-+ + + +-+-+ + + +          
|     | | |     | | |          
+-+ + + + + +-+-+ + +          
|   | | | | |     | |          
+ +-+ +-+ + +-+-+-+ +          
| | |   | |   |   | |          
+ + +-+ + +-+ + + + +          
|     |   |   | | | |          
+ +-+ +-+-+ +-+-+ + +          
|   |     | |       |          
+-+ +-+-+-+ + +-+-+-+          
|   | |     |     | |          
+ +-+ + +-+-+-+-+ + +          
|     |             |          
+-+-+-+-+-+-+-+-+-+-+          
