+-+-+-+-+-+-+-+-+-+-+-+-+-+-+-+-+-+
|       |   |   |   |     |       |
+-+ +-+ +-+ +-+ + + +-+-+ + + +-+-+
| | | |     |   | | |   |   | |   |
+ + + +-+-+-+ +-+ + + + +-+ +-+ + +
| |   |     |     |   |   | |   | |
+ + +-+-+-+ +-+ +-+-+ +-+ + + +-+ +
|       |   |   |   | | |     |   |
+-+ + + + +-+ +-+ +-+ + +-+-+-+ +-+
| | | |   |     | |   |       |   |
+ + + +-+-+-+-+-+ + + + +-+-+ +-+ +
|   |     |         | |   |   |   |
+-+ +-+-+ + +-+-+ +-+-+-+-+ + + +-+
|   |     |   |   |         | | | |
+ +-+ +-+-+-+ +-+-+-+-+-+ +-+ + + +
| |   |     | |     |   |   |   | |
+ + +-+-+-+ + + +-+ + + + + +-+-+ +
| |           |   | | | | | |     |
+ + +-+-+-+-+ +-+ + + + + + + +-+-+
| | |   |   |   | | | | | |   |   |
+ + + + + + + +-+ + + +-+ +-+-+ + +
| | | |   | | |   | |     |   | | |
+ +-+ +-+-+ + + +-+ +-+-+-+ +-+ +-+
|   |     | |   |         |       |
+ + +-+-+ +-+-+-+ +-+-+-+-+-+-+-+ +
| |   | |         |           |   |
+-+-+ + + +-+-+ +-+ +-+-+-+-+ + +-+
|   | |   |   |     |       | |   |
+ +-+ +-+-+ + + +-+ + +-+-+ + + +-+
| |   |     | | | | | |     |     |
+ + +-+ +-+ + + + + + +-+-+-+-+ + +
| |   | |   | |   | |     |   | | |
+ +-+ + + +-+ +-+-+ +-+-+ + + + + +
|     | |   |           |   |   | |
+-+-+-+-+-+-+-+-+-+-+-+-+-+-+-+-+-+
