+-+-+-+-+-+-+-+-+-+-+
| |     |   |   |   |
+ + +-+ +-+ + + + + +
| | | |   | | |   | |
+ + + + + + + + +-+-+
|   |   |   | | |   |
+ + +-+-+-+-+ +-+ + +
| |         | |   | |
+-+-+-+ +-+ + + +-+ +
|   |   | | |     | |
+ +-+ +-+ + +-+-+-+ +
| |     | | | |     |
+ + +-+ + + + + +-+-+
|   |   | |   |     |
+-+ + +-+ + +-+ +-+ +
|   |     |     |   |
+ +-+-+-+-+-+-+-+ +-+
| |           | |   |
+ +-+-+-+-+-+ + +-+ +
|             |     |
+-+-+-+-+-+-+-+-+-+-+
