+-+-+-+-+-+-+-+-+-+-+-+-+-+-+-+-+-+
|           |         |     |     |
+ +-+-+-+-+-+ +-+ +-+-+ +-+ + +-+ +
| |       |   |     |   |     | | |
+ + +-+-+ + +-+ +-+ + + + +-+-+ + +
|   |     | |   | |   | |   |     |
+-+-+ +-+ +-+ +-+ +-+-+-+-+ + +-+-+
|       | |   |       |     |     |
+ + +-+ + + + + +-+ + + +-+-+-+-+ +
| |   | |   | |   | | | |   |     |
+-+-+-+ +-+-+-+-+ +-+ + + + + + +-+
|       |       | |   |   | | |   |
+ +-+-+-+ +-+-+ + + +-+-+ + +-+ + +
|       | |     | |   |   |   | | |
+ +-+-+ + + + +-+ +-+ +-+-+-+ +-+ +
|     |   | |   | | | |       |   |
+-+ + +-+-+-+-+ + + + + +-+-+-+ + +
| | |   |       |   | |   |     | |
+ + +-+ +-+ +-+-+-+ + +-+ + +-+-+ +
|   |   |   | |   | |     |   | | |
+-+-+-+-+ +-+ + + + +-+-+-+-+ + + +
|   |     | |   | | | |       | | |
+ + + +-+-+ +-+-+ + + + +-+-+-+ + +
| | |   |   |     |   | |     | | |
+ + + + +-+ + +-+-+-+-+ + +-+ + + +
| |   | |   |   |     | | |     | |
+ +-+-+ + +-+-+ +-+ + +-+ + +-+-+ +
| |   |   |   | |   |   | |   |   |
+-+ + +-+-+-+ + + +-+-+ +-+ + + +-+
|   |           | |   |     | |   |
+ +-+-+-+-+-+-+ + + + +-+-+-+ +-+ +
|   |     |     | | | |         | |
+-+ + +-+ + + +-+ + + +-+-+ +-+ + +
|   |   |   |     | |       |     |
+-+-+-+-+-+-+-+-+-+-+-+-+-+-+-+-+-+
