+-+-+-+-+-+-+-+-+-+-+-+-+-+-+-+
| |           |       |     | |
+ + +-+-+-+-+ + +-+-+-+ + + + +
| |   |     | |         | |   |
+ + + + +-+-+ +-+-+-+-+-+ +-+ +
| | | |       |             | |
+ + + + +-+-+-+ +-+-+ +-+-+-+ +
|   | | |   |   |     |     | |
+-+-+ +-+ + + +-+ + +-+ +-+ + +
|   |   | |   | | |   |   |   |
+ + +-+ + +-+-+ + + + +-+ +-+-+
| |     |   | |   | |   |     |
+ +-+-+-+-+ + +-+-+-+-+ +-+-+ +
|       |   |   |     |   |   |
+-+-+-+ +-+-+ + + +-+ +-+ + + +
|     |   |   | |   | |   | | |
+ +-+ +-+ + + + +-+-+ + +-+ + +
|   | |   | | |   |   | |   | |
+ + +-+ +-+-+ +-+-+ + +-+ +-+ +
| |         |   |   | |   | | |
+-+-+-+ + + +-+ + +-+ + +-+ + +
|       | |   |     |     |   |
+ +-+-+-+ +-+ + +-+-+-+ + +-+-+
| |   |   |   | |     | |     |
+-+ + + +-+-+-+ + +-+ + +-+-+ +
|   |     |     |   |   |   | |
+ +-+-+-+-+ +-+-+ +-+-+-+ +-+ +
| |         |   | |   | | |   |
+ + +-+-+ +-+-+ + + + + + + +-+
|   |           |   |   |     |
+-+-+-+-+-+-+-+-+-+-+-+-+-+-+-+
