+-+-+-+-+-+-+-+-+-+-+-+-+-+-+-+
| |     |   |     |   |       |
+ +-+ + +-+ + +-+-+ + + +-+ + +
|     |   |   |     |   |   | |
+-+-+-+-+ +-+ + +-+-+-+-+-+ + +
|     |   |       |     |   | |
+ +-+-+ + +-+-+-+ + + +-+ +-+ +
| | |   | |       | | |   |   |
+ + + + +-+ +-+-+-+ +-+ + +-+-+
|   | |   | |     |     | |   |
+ +-+ + + + +-+ + +-+-+-+ + + +
|     | | |   | |       | | | |
+-+-+-+-+ +-+ +-+-+-+-+ + + + +
|   |   |     |   |       | | |
+ +-+ + +-+ +-+ + + + +-+-+ + +
|     |     |   |   |   |   | |
+-+-+-+ +-+-+-+-+-+-+-+ + + + +
|       |             |   | | |
+ + +-+-+ + +-+-+-+-+ +-+-+ +-+
| | |   | |   | |         |   |
+ + + +-+ +-+ + + +-+-+-+ +-+ +
| |   |   | |   |       |   | |
+ +-+ + +-+ + +-+-+-+-+ +-+ + +
| |   |     | | |         | | |
+ +-+-+-+-+-+ + + +-+-+-+ +-+ +
| |       |   |   |   |   |   |
+ + +-+-+ + +-+-+-+ + + +-+ +-+
| | |     |         | |   |   |
+ + +-+-+-+ +-+-+-+ + +-+ +-+ +
| |         |       |   |     |
+-+-+-+-+-+-+-+-+-+-+-+-+-+-+-+
